			11111111    
			10000001
		10000001
		100PEC01      
		10000001      
		10000001    
		11111111    					






