11111111111
1P00MMMM001
10000000001
10CCCCCCC01
1E000000001
11111111111